{
  "id": 116,
  "board": [
    [7, 0, 0, 0, 0, 0, 0, 0, 0, 0, 0, 0, 0, 0, 0, 7],
    [1, 0, 7, 1, 2, 7, 2, 1, 1, 7, 0, 0, 0, 0, 0, 1],
    [1, 0, 0, 0, 1, 0, 1, 0, 0, 0, 0, 7, 1, 1, 2, 2],
    [2, 1, 2, 1, 2, 0, 2, 1, 1, 1, 2, 7, 0, 0, 1, 1],
    [1, 0, 1, 0, 1, 0, 1, 0, 0, 0, 1, 0, 7, 0, 1, 1],
    [1, 0, 1, 7, 2, 1, 7, 0, 0, 0, 1, 0, 1, 0, 1, 7],
    [1, 0, 1, 0, 0, 0, 0, 0, 0, 0, 1, 0, 1, 0, 1, 0],
    [7, 0, 1, 0, 0, 0, 0, 0, 0, 0, 1, 0, 2, 2, 2, 0],
    [0, 0, 2, 1, 1, 1, 1, 2, 1, 1, 2, 0, 7, 1, 1, 0],
    [0, 0, 1, 0, 0, 0, 0, 1, 0, 0, 1, 0, 0, 1, 1, 0],
    [0, 0, 1, 0, 0, 0, 0, 1, 7, 1, 2, 1, 1, 2, 1, 0],
    [0, 0, 1, 0, 0, 0, 0, 1, 0, 0, 0, 0, 0, 1, 1, 0],
    [0, 0, 1, 0, 0, 0, 0, 1, 0, 0, 0, 0, 0, 1, 1, 0],
    [0, 0, 1, 0, 0, 0, 0, 1, 0, 0, 0, 0, 0, 1, 1, 0],
    [7, 1, 2, 1, 1, 1, 7, 0, 0, 0, 0, 0, 0, 1, 1, 0],
    [0, 0, 0, 0, 0, 0, 7, 1, 1, 1, 1, 1, 1, 2, 7, 0]
  ],
  "player": { "x": 7, "y": 13, "direction": 1 },
  "stars": 18,
  "functions": [{ "instructions": [], "length": 10 }],
  "activeInstructions": [
    "FW",
    "TL",
    "TR",
    "C1",
    "C2",
    "C3",
    "P1",
    "P2",
    "P3",
    "F0"
  ]
}
