{
  "id": 88,
  "board": [
    [0, 0, 0, 0, 0, 0, 0, 0, 0, 0, 0, 0, 0, 0, 0, 0],
    [0, 0, 0, 0, 0, 0, 0, 0, 0, 0, 0, 0, 0, 0, 0, 0],
    [0, 0, 0, 0, 0, 0, 0, 0, 0, 0, 0, 0, 0, 0, 0, 0],
    [0, 0, 0, 0, 0, 0, 0, 0, 0, 0, 0, 0, 0, 0, 0, 0],
    [0, 0, 3, 3, 3, 3, 3, 1, 3, 3, 3, 3, 3, 0, 0, 0],
    [0, 0, 3, 0, 0, 0, 0, 0, 0, 0, 0, 0, 3, 0, 0, 0],
    [0, 0, 3, 0, 3, 3, 3, 1, 3, 3, 3, 0, 3, 0, 0, 0],
    [0, 0, 1, 0, 3, 0, 0, 0, 0, 0, 3, 0, 3, 0, 0, 0],
    [0, 0, 3, 0, 7, 0, 3, 2, 3, 0, 1, 0, 1, 0, 0, 0],
    [0, 0, 3, 0, 0, 0, 2, 0, 1, 0, 3, 0, 3, 0, 0, 0],
    [0, 0, 3, 3, 1, 3, 3, 0, 3, 1, 3, 0, 3, 0, 0, 0],
    [0, 0, 0, 0, 0, 0, 0, 0, 0, 0, 0, 0, 3, 0, 0, 0],
    [0, 0, 3, 3, 3, 3, 3, 1, 3, 3, 3, 3, 3, 0, 0, 0],
    [0, 0, 0, 0, 0, 0, 0, 0, 0, 0, 0, 0, 0, 0, 0, 0],
    [0, 0, 0, 0, 0, 0, 0, 0, 0, 0, 0, 0, 0, 0, 0, 0],
    [0, 0, 0, 0, 0, 0, 0, 0, 0, 0, 0, 0, 0, 0, 0, 0]
  ],
  "player": { "x": 2, "y": 12, "direction": 2 },
  "stars": 1,
  "functions": [
    { "instructions": [], "length": 3 },
    { "instructions": [], "length": 4 },
    { "instructions": [], "length": 3 }
  ],
  "activeInstructions": [
    "FW",
    "TL",
    "TR",
    "C1",
    "C2",
    "C3",
    "P1",
    "P2",
    "P3",
    "F0",
    "F1",
    "F2"
  ]
}
